10
15
@..@@@..@@.@...
...@@...@@.....
.@......@......
.....@.........
@..@@@..@@.....
...............
...............
...............
@..@@..........
...............
3
9,0,1,14
2,4,9,13
8,2,6,13