10
15
.@..........@..
...............
...........@...
..............@
....@..........
...............
......@@.....@.
..............@
.......@.......
...............
7
5,9,6,10
9,6,6,0
3,2,6,12
7,11,9,0
6,9,5,0
1,1,2,4
7,13,1,6