8
8
..@.@.@.
...@...@
...@..@.
@.@.....
....@...
...@@.@.
........
.@@.....
3
1,5,2,4
1,4,2,5
6,0,0,5