10
15
@..@@..@.@@..@.
.......@.@@..@.
.........@@....
...............
@..@@....@@....
@..@@....@@....
@..@@....@@....
...............
...............
@..@@....@@....
8
3,3,6,13
7,6,7,13
9,6,3,10
9,5,3,11
3,0,8,10
3,14,8,2
6,14,9,7
2,1,9,12
