10
15
@..@@..@.@@..@.
.......@.@@..@.
.........@@....
...............
@..@@....@@....
@..@@....@@....
@..@@....@@....
...............
...............
@..@@....@@....
5
3,5,9,12
3,2,7,5
8,1,3,13
1,1,2,12
8,13,5,1
